...###.....
..##.#.####
.##..###..#
##........#
#...@..#..#
###..###..#
..#..#....#
.##.##.#.##
.#......##.
.#######...